R 500 550
NO textures/wall_1.xpm
SO textures/wall_1.xpm
WE textures/wall_1.xpm
EA textures/wall_1.xpm

S textures/wall_1.xpm
F 220,100,0

C 225,30,0

        1111111111111111111111111
        1000000000110000000000001
        1011000001110000002000001
        10010000000000000000000011
111111111011000001110000000000001
100000000011000001110111111111111
11110111111111011100000010001
11110111111111011101010010001
11000000110101011100000010001
100020000000000011000N0010001
10000000000000110001010010011
1100000111010101111101111000111111
11110111 1110101 10111101000000001
11111111 1111111 11111111111111111
