R 700 500
NO textures/wall_1.xpm    
SO textures/wall_2.xpm
WE textures/wall_3.xpm
EA textures/wall_4.xpm
S textures/barrel.xpm
F 39,99,55
C 140,191,209

        1111111111111111111111111
        1000000000110000000000001
        1011000001110000002000001
        1001000000000000000000001
111111111011000001110000000000001
100000000011000001110000000111111
11110111111111011100000000001
11110111111111011101000000001
11000000110101000000000000001
10002000000000000000W00000001
10000002000000000001010010011
1100000111010101111101111000111111
11110111 1110101 10111101000000001
11111111 1111111 11111111111111111
