R 500 55aaa
NO textures/wall_1.xpm
SO textures/wall_1.xpm
WE textures/wall_1.xpm
EA textures/wall_1.xpm

S textures/wall_1.xpm
F 220,100,0

C 225,30,0

111111
100101
102001
1100N1
111111